******************************
*                       *   E*
* ************ ************* *
* *                          *
* * ***** **************** * *
* * *                    * * *
* * * ****************** * * *
*** * *                *   * *
*   * ****** *********** *** *
* *   * * *          * * * * *
* *** * * ********** *   * * *
* * *   * *        *** * * * *
* * * * * * ******** * * * ***
* * * * *   *        * * * * *
* * * **** ***** ******* * * *
* * ***                *** * *
*   * ****************** * ***
* * *                    * * *
* * ********************** * *
***                        * *
* ****** ******************* *
*S                           *
******************************
